volcanes	volcán
época
habitantes	habitante
necesarios	necesario
muéstrame
políticos	político
operación
películas	película
programa	programar
granos	grano
sirve	servir
aparecieron	aparecer
pescado	pescar
ganado	ganar
menor
faro
participan	participar
series televisivas
gente
vicepresidente
participa	participar
llame	llamar
lanzados	lanzar
presidente
cuba
líderes	líder
expuesto	exponer
líneas	línea	líneo
nadadores	nadador
condados	condado
persona	personar
tocaba	tocar
asesinado	asesinar
desarrolló	desarrollar
cruza	cruzar
estudiantes	estudiante
desembocan	desembocar
personas	persona	personar
cumpleaños
joven
contiene	contener
hijo
proteina
graduado	graduar
activo	activar
neto
tarta
gobierno	gobernar
numero	numerar
peligro	peligrar
astronautas	astronauta
inspiro	inspirar
alemanas	alemán
obtuvo	obtener
proyecto	proyectar
interpreto	interpretar
juegos	juego
común
aerodeslizadores	aerodeslizador
disparado	disparar
episodios	episodio
programado	programar
canción
suizas	suizo
informático
oficial
productos	producto
premio nobel
cuidad	cuidar
sucesor
idioma oficial
sede	sedar
fluye	fluir
recibido	recibir
profesionales	profesional
partidos	partir	partido
involucrado	involucrar
festivos	festivo
actor
invasión
juntos	junto
descubrió	descubrir
cervecerías	cervecería
tierra
empresas	empresa
álbum
carrera
montaña
nació	nacer
pagaría	pagar
estilo	estilar
sitúa	situar
compuso	componer
pinto	pintar
protagonizan	protagonizar
dirigido	dirigir
extinción
fábrica
artístico
vive	vivir
cuesta	costar
subsidiario
nacido	nacer
alemanos
nietos	nieto
canciones	canción
expresa	expresar	expreso
caras	cara	caro
rey
premios	premio
alemán
alcalde
estadio
miembros	miembro
postres	postre	postrar
ganó	ganar
verdes	verde
futbol
fecha	fecho	fechar
horaria	horario
pilares	pilar
asesino	asesinar
altura
actuó	actuar
ciudad
lealtad
cuidades
fundación
región
publicados	publicar
suecos	sueco
viven	vivir
reina	reinar
bajos	bajo
paga	pagar
residen	residir
nacieron	nacer
murió	morir
ajedrez
aéreas	aéreo
científicos	científico
color
dirigió	dirigir
aeropuertos	aeropuerto
hijos	hijo
pertenezcan	pertenecer
operadas	operar
significa	significar
oceanógrafos	oceanógrafo
casado	casar
presidentes	presidente
casada	casar	casado
termina	terminar
américa
juega	jugar
esposa	esposar	esposo
góticos	gótico
termino	terminar
influenciados	influenciar
abreviación
ciudades	ciudad
dirigidas	dirigir
lenguajes	lenguaje
mortal
diferencia	diferenciar
canadienses	canadiense
surfistas	surfista
ingredientes	ingrediente
país
ranas	rana
icro
ingeniero
une	unir
grande
nacimiento
skateboarders
musicales	musical
contienen	contener
dame
discográfica	discográfico
páises
taikonautas
hondo
conocidos	conocer	conocido
tipo
software
completo	completar
escribió	escribir
soltera	soltero
ganancia
cosmonautas	cosmonauta
crece	crecer
cacao
plataformas	plataforma
antigua	antiguar	antiguo
río	reír
jugador
músico
música	músico
fundó	fundar
actua
república
famoso
producido	producir
princesa
dueño
países	país
muerte
enterrada	enterrar
organizaciones	organización
lago
idiomas	idioma
muerto	morir
animales	animal
murieron	morir
galleta
misiones	misión	misionar
anfitrión
empieza	empezar
lanzamiento
enterrado	enterrar
lugares	lugar
chocolate
bebida	beber
población
influencia	influenciar
dirigio
premio	premiar
queen
química	químico
cohetes	cohete
peliculas
influenciado	influenciar
universidad
volcanos
escritores	escritor
literatura
bahía
electrónica	electrónico
muestrame
creador
presupuesto	presuponer	presupuestar
demócrata
influenciaron	influenciar
baloncesto
web
nacidos	nacer	nacido
moneda	monedar
japonés
diseñó	diseñar
escrito	escribir
partido	partir
checa	checo
banda
edificios	edificio
editor
nace	nacer
programación
benéficas	benéfico
prefijo	prefijar
grupos	grupo
videojuego
actuado	actuar
produce	producir
conductor
holandeses	holandés
poeta
instrumentos	instrumento
libros	libro
artistas	artista
jóven
autobiografía
televisión
zanahorias	zanahoria
comenzó	comenzar
erupcionado
capital
museo
vino	venir
cuevas	cueva
cerveza
doctorado	doctorar
compañías	compañía
grupo
padres	padre
número
casados	casar	casado
fundadas	fundar
participó	participar
casó	casar
zona
papa	papar
especiales	especial
abrevia	abreviar
visitantes	visitante
anfibio
entra	entrar
juegan	jugar
étnicos	étnico
baguette
fundo	fundar	fundir
lucro	lucrar
actores	actor
lista	listo	listar
libro	librar
dardos	dardo
crisis
páginas	página
pertenece	pertenecer
producen	producir
empleados	emplear	empleado
alemana	alemán
misión
paginas	paginar
física	físico
protagonizadas	protagonizar
página
ideó	idear
empresa
supervisor
unidos	unir
año
metros	metro
desarrolladores	desarrollador
película
danesas	danés
causa	causar
ruta
meca
militares	militar
grabó	grabar
escritos	escribir	escrito
hija	hijo
islas	isla
australianos	australiano
pasa	paso	pasar
alto
lenguas oficiales
forma	formar
nombre	nombrar
cancilleres	canciller
animales extintos
vuela	volar
juliana	juliano
lenguaje
trompeta
desarrollados	desarrollado	desarrollar
metalcore
puentes	puente
cochinos	cochino
clubs	club
fundador
calorías	caloría
uva
tocan	tocar
actúan	actuar
costo
album
conflictos	conflicto
productoras	productor
ríos	río
guerra
jugadores	jugador
cruzan	cruzar
checas	checo
vino espumoso
carreras	carrera
creó	crear
prímera
animo	animar
alta	alto
favor
programas	programar	programa
serie	seriar
museos	museo
monárcas
viene	venir
imperio antiguo
fué
proinsulina
politico
